BamH1	GGATCC
Dra1	TTTAAA
EcoR1	GAATTC
HindIII	AAGCTT
Spe1	ACTAGT
Xho1	CTCGAG
EcoRV	GATATC
Fba I	TGATCA
Hae II	AGCGCC
Hae II	GGCGCC
Kpn I	GGTACC
Mfl I	AGATCC
Mfl I	AGATCT
Mfl I	GGATCC
Mfl I	GGATCT
Not I	GCGGCCGC
Sac I	GAGCTC
Sal I	GTCGAC
Sma I	CCCGGC
Spe I	ACTAGT
Taq I	TCGA
Xba I	TCTAGA
Xho I	CTCGAG
Mbo I	GATC
Nde1	CATATG